{
    "width": 30,
    "height": 30,
   "map_tiles": [
   [0, 1, 2, 1, 0, 126, 1, 0, 2, 0, 1, 0, 2, 0, 1, 2, 1, 0, 2, 1, 0, 2, 1, 0, 2, 1, 0, 2, 1, 0],
    [1, 2, 0, 2, 1, 144, 1, 2, 0, 1, 2, 1, 0, 1, 2, 0, 2, 1, 0, 2, 1, 0, 2, 1, 0, 1, 2, 0, 2, 1],
    [2, 0, 1, 0, 2, 144, 0, 2, 1, 0, 1, 0, 2, 1, 0, 2, 1, 0, 1, 2, 0, 1, 2, 1, 0, 1, 2, 0, 1, 2],
    [1, 0, 3, 4, 0, 144, 1, 0, 2, 1, 0, 2, 1, 0, 2, 0, 1, 2, 1, 0, 1, 2, 1, 0, 2, 1, 0, 2, 1, 0],
    [0, 1, 21, 22, 2, 144, 1, 2, 0, 2, 1, 0, 2, 0, 1, 0, 2, 1, 0, 1, 2, 0, 2, 1, 0, 1, 2, 1, 0, 2],
    [1, 2, 1, 0, 2, 144, 0, 2, 0, 1, 2, 1, 0, 1, 1, 2, 1, 2, 1, 0, 2, 1, 0, 1, 2, 0, 1, 2, 0, 1],
    [2, 0, 1, 2, 1, 144, 2, 1, 0, 2, 1, 0, 2, 2, 0, 1, 0, 2, 1, 0, 2, 1, 0, 2, 1, 0, 2, 1, 0, 2],
    [0, 2, 1, 0, 2, 144, 0, 2, 1, 0, 2, 1, 0, 2, 1, 0, 1, 2, 1, 0, 2, 1, 0, 2, 1, 0, 1, 2, 0, 2],
    [1, 0, 2, 1, 0, 144, 1, 0, 2, 1, 0, 2, 1, 0, 2, 1, 0, 1, 2, 0, 2, 1, 0, 2, 1, 0, 1, 2, 1, 0],
    [2, 1, 0, 2, 1, 144, 1, 2, 0, 2, 1, 0, 2, 1, 0, 1, 2, 1, 0, 2, 1, 0, 2, 1, 0, 2, 1, 0, 2, 1],
    [0, 2, 1, 0, 1, 144, 1, 0, 2, 1, 0, 2, 1, 0, 1, 2, 0, 2, 1, 0, 2, 1, 0, 1, 2, 0, 2, 1, 0, 2],
    [1, 0, 2, 1, 0, 144, 1, 0, 2, 0, 1, 2, 1, 0, 2, 1, 0, 1, 2, 0, 1, 2, 1, 0, 2, 1, 0, 1, 2, 1],
    [2, 1, 0, 2, 1, 163, 110, 110, 110, 110, 110, 110, 110, 110, 110, 110, 129, 1, 2, 1, 0, 1, 2, 0, 1, 2, 0, 1, 2, 1],
    [0, 2, 1, 0, 1, 2, 0, 1, 2, 0, 1, 2, 1, 0, 2, 1, 144, 2, 1, 0, 1, 2, 1, 0, 2, 1, 0, 1, 2, 0],
    [0, 1, 2, 1, 0, 1, 2, 1, 0, 2, 1, 0, 2, 1, 0, 1, 144, 0, 2, 1, 0, 1, 2, 1, 0, 2, 1, 0, 2, 1],
    [2, 1, 1, 0, 1, 0, 2, 1, 0, 1, 2, 0, 2, 1, 0, 1, 144, 1, 0, 1, 2, 0, 1, 2, 0, 2, 1, 0, 2, 1],
    [0, 1, 2, 2, 0, 2, 1, 0, 2, 1, 0, 2, 1, 0, 2, 1, 144, 2, 1, 0, 1, 2, 1, 0, 1, 2, 0, 1, 2, 1],
    [1, 2, 0, 2, 1, 1, 1, 2, 0, 1, 2, 1, 0, 2, 1, 0, 144, 1, 0, 1, 2, 0, 1, 2, 1, 0, 2, 1, 0, 1],
    [2, 0, 1, 0, 2, 0, 1, 2, 1, 0, 2, 1, 0, 1, 2, 1, 163, 110, 110, 110, 110, 110, 110, 110, 110, 110, 110, 110, 110, 111],
    [1, 2, 1, 0, 2, 1, 0, 2, 1, 0, 2, 1, 0, 1, 2, 0, 2, 1, 0, 2, 1, 0, 1, 2, 1, 0, 1, 2, 0, 2],
    [0, 2, 1, 0, 1, 2, 0, 1, 2, 1, 0, 2, 1, 0, 2, 0, 1, 2, 1, 0, 2, 1, 0, 2, 1, 0, 1, 2, 0, 1],
    [1, 0, 2, 1, 0, 1, 2, 1, 0, 2, 0, 1, 2, 0, 1, 2, 1, 0, 1, 2, 0,  2, 1, 0, 2, 1, 0, 2, 1, 0],
    [2, 1, 0, 2, 1, 0, 2, 1, 0, 1, 2, 0, 1, 2, 0, 1, 2, 1, 0, 1, 2, 0, 1, 2, 1, 0, 2, 0, 1, 2],
    [1, 2, 0, 1, 2, 1, 0, 2, 1, 0, 2, 1, 0, 2, 1, 0, 2, 0, 1, 2, 1, 0, 2, 1, 0, 2, 1, 0, 1, 2],
    [0, 1, 2, 1, 0, 2, 1, 0, 2, 1, 0, 2, 1, 0, 2, 1, 0, 1, 2, 1, 0, 2, 1, 0, 1, 2, 0, 1, 2, 1],
    [2, 1, 0, 1, 2, 1, 0, 2, 0, 1, 2, 0, 1, 2, 0, 1, 2, 1, 0, 2, 0, 1, 2, 1, 0, 2, 1, 0, 2, 1],
    [1, 2, 0, 2, 1, 0, 1, 2, 1, 0, 2, 1, 0, 2, 1, 0, 1, 2, 0, 2, 1, 0, 2, 1, 0, 1, 2, 0, 2, 1],
    [0, 1, 2, 1, 0, 2, 1, 0, 2, 1, 0, 2, 1, 0, 2, 1, 0, 1, 2, 1, 0, 2, 1, 0, 2, 1, 0, 2, 1, 0],
    [1, 0, 2, 1, 0, 1, 2, 1, 0, 2, 1, 0, 1, 2, 0, 1, 2, 1, 0, 1, 2, 0, 1, 2, 1, 0, 2, 1, 0, 2],
    [0, 1, 2, 1, 0, 2, 1, 0, 2, 0, 1, 0, 2, 0, 1, 2, 1, 0, 2, 1, 0, 2, 1, 0, 2, 1, 0, 2, 1, 0]
  ]
  }
  